{
  "levels": [
    {
      "name": "World 1-1",
      "time": 400,
      "map": [
        "................................................................",
        "................................................................",
        "................................................................",
        ".........................C......................................",
        "....................B..B???..C..................................",
        "...............C.........................C......................",
        ".................B.....C.............B..........................",
        "...............BBB...................BBB..............C.........",
        "S............................................................F..",
        "XXXXXXXXXXXXXXXXXXXX...XXXXXXXXXXXXXX...XXXXXXXXXXXXXXXXXXXXXXXX",
        "XXXXXXXXXXXXXXXXXXXX...XXXXXXXXXXXXXX...XXXXXXXXXXXXXXXXXXXXXXXX"
      ],
      "enemies": [
        { "x": 18, "y": 8 },
        { "x": 26, "y": 8 },
        { "x": 45, "y": 8 }
      ]
    },
    {
      "name": "World 1-2",
      "time": 350,
      "map": [
        "................................................................",
        "................................................................",
        ".................C.........................C....................",
        "......................BBB.............BBB.......................",
        "............C....B..............C..............B................",
        "............B....B???....B.....................B................",
        ".................B...............C.............B................",
        "..........BBB..............................BBB..................",
        "S.................C...............C.........................F...",
        "XXXXXXXXXXXXXX...XXXXXXXX......XXXXXXXXX...XXXXXXXXXXXXXXXXXXXXXX",
        "XXXXXXXXXXXXXX...XXXXXXXX......XXXXXXXXX...XXXXXXXXXXXXXXXXXXXXXX"
      ],
      "enemies": [
        { "x": 12, "y": 8 },
        { "x": 22, "y": 7 },
        { "x": 35, "y": 8 },
        { "x": 52, "y": 8 }
      ]
    },
    {
      "name": "World 1-3",
      "time": 300,
      "map": [
        "................................................................",
        "....................C...............C...............C...........",
        "..............BBB...............................................",
        "...........C.............C..............C.......................",
        "......B???.......B???...........B???...........B???.............",
        "..................B......................B......................",
        "..............BBB..............BBB......................BBB.....",
        "....C..........................................................",
        "S...............C...............C.........................F.....",
        "XXXXXXXXX...XXXXXXXXXXXX...XXXXXXXXXXXX...XXXXXXXXXXXX...XXXXXXX",
        "XXXXXXXXX...XXXXXXXXXXXX...XXXXXXXXXXXX...XXXXXXXXXXXX...XXXXXXX"
      ],
      "enemies": [
        { "x": 9, "y": 8 },
        { "x": 20, "y": 6 },
        { "x": 33, "y": 8 },
        { "x": 48, "y": 7 },
        { "x": 56, "y": 8 }
      ]
    }
  ]
}
